3323232323232323233
2000000000000000002
1000000000000000001
2000000000000000002
3323232323232323233
