21222222222
20000000002
20003030002
20000000002
20003030002
20000000002
44444444444
