111111111
200000004
200000004
200005004
200000004
233333334
