111111111111111111111111
100000000000000000000001
100000000000000000000001
100000000000000000000001
100000222220000505050001
100000200020000000000001
100000200020000500050001
100000200020000000000001
100000220220000505050001
100000000000000000000001
100000000000000000000001
100000000000000000000001
100000000000000000000001
100000000000000000000001
100000000000000000000001
100000000000000000000001
144444444000000000000001
140400004000000000000001
140000604000000000000001
140400004000000000000001
140444444000000000000001
140000000000000000000001
144444444000000000000001
111111111111111111111111
