11144444
10103005
10103005
10100005
10103005
10003005
22223555
