222222222222222222222222222222222
100000000000000000000000000000003
100000000000000000000000000000003
222222222222222222222222222222203
222222222222222222222222222222203
400000000000000000000000000000003
400000000000000000000000000000003
403333333333333333333333333333333
404444444444444444444444444444444
400000000000000000000000000000001
400000000000000000000000000000001
455555555555555555555555555555555
